A
A
A
A
A
AAEEEAAEEEAAAEEEEEAAAAEEAAAAEEAAAAAAEEAAAEEEAAAEEAAAEEEEEAAAEEEAAAAAAEEAAEE
AAEEEAAEEAAEEEEEEEEAAAEEAAAAEEAAAAAAEEAAAEEEAAAEEAEEEEEEEEAAEEEEAAAAAEEAAEE
AAAEEEEEEAAEEEAAAEEEAAEEAAAAEEAAAAAAEEAAAEEEAAAEEAEEEAAAEEEAEEEEEAAAAEEAAEE
AAAAEEEEAAAEEAAAAAEEAAEEAAAAEEAAAAAAAEEAEEEEEAEEAAEEAAAAAEEAEEAEEEAAAEEAAEE
AAAAEEEEAAAEEAAAAAEEAAEEAAAAEEAAAAAAAEEAEEAEEAEEAAEEAAAAAEEAEEAAEEEAAEEAAEE
AAAAAEEAAAAEEAAAAAEEAAEEAAAAEEAAAAAAAEEAEEAEEAEEAAEEAAAAAEEAEEAAAEEEAEEAAEE
AAAAAEEAAAAEEAAAAAEEAAEEAAAAEEAAAAAAAAEEEEAEEEEAAAEEAAAAAEEAEEAAAAEEEEEAAAA
AAAAAEEAAAAEEEAAAEEEAAAEEAAEEAAAAAAAAAEEEEAEEEEAAAEEEAAAEEEAEEAAAAAEEEEAAEE
AAAAAEEAAAAAAEEEEEEAAAAAEEEEAAAAAAAAAAAEEAAAEEAAAAAAEEEEEEAAEEAAAAAAEEEAAEE